###################################################
###################################################
##################################e################
###...............######....######.###########.####
###.#############.#...##.##.######........####.####
###.###4...######.#.#.#..#..#############..##..####
###.##..##..........#...###..#############....#####
###.###.####################.#####.######..########
###.##..#####...........3###5............5#########
###.###.#####.##########.##########################
###.###.#####.##########.#######.....##############
###.###4......##########.###########.##############
###.###########......###.............####...#######
###############.########.################.#########
####.#####.####.#####...3#######....#####.#########
####.#####.####.#####.##########.##.#####.#########
##1.........1##.#####.#####......##.......#########
##.#########.##.#####.......#######.######...######
##.#########.##.###################........#.######
##.....#####......###2......2###############.######
######.##########.###.###.##.######..........######
######....#######.###.###.##.######.####.##########
##...####.#######.###...#.##.######.###############
####.####.#######.#####.#.##........###############
####.##0......0##.......#.#########################
##....###.###############....................######
##.##.###.########.....###########.#########.######
##.##.....#######..###############....######...####
##s################################################
###################################################
###################################################